####################
#                 %#
#      =####    ####
#      =       #####
#   =###############
#   =             -#
#   =         =#####
##  =         =    #
### =         =    #
############# =    #
##############=    #
#             =    #
#             =   ##
##            =  ###
####################
