####################
#                 %#
#               ####
#              #####
#    ###############
#                  #
#                  #
##                 #
###                #
#############      #
##############     #
#                  #
#                 ##
#                ###
####################