####################
#                 %#
#               ####
#              #####
#   =###############
#   =             -#
#   =         =#####
##  =         =    #
### =         =    #
############# =    #
##############=    #
#             =    #
#             =   ##
#             =  ###
####################
