####################
#                  #
###=               #
#  =               #
############= ######
#           =  =   #
#        =#####=   #
#        =    #=  -#
###########=  ######
#          =       #
#   =###############
#   =              #
#   =#####   =#=   #
#   =        =#=  %#
####################
