####################
#                  #
###                #
#                  #
############  ######
#                  #
#         #####    #
#             #    #
###########   ######
#                  #
#    ###############
#                  #
#    #####    #    #
#             #   %#
####################