####################
#                  #
#                  #
#                  #
################   #
#                  #
#                  #
#   ################
#                  #
#                  #
################   #
#                  #
#                  #
#                  #   
####################