####################
##       -        ##
#     =######      #
###=  =         =###
#  = #=       # =  #
#  = ##      ## =  #
#  = ###=   ### =  #
####=#  =     # ####
#   =#  ####  #   =#
#=################=#
#=                =#
################# =#
#                 =#
#%                =#
####################
