####################
##     ######     ##
#         -        #
###=   ######   =###
#  = #        # =  #
#  = ##      ## =  #
#  = ###=   ### =  #
###= #  =     # ####
#  = #  ####  #   =#
#=################=#
#=                =#
###############=  =#
#                 =#
#%                =#
####################
