####################
##       -        ##
#     =######      #
###=  =         =###
#  = #=       # =  #
#  = ##      ## =  #
#  = ###=   ### =  #
###= #  =     # ####
#  = #  ####  #   =#
#=################=#
#=                =#
###############=  =#
#                 =#
#%                =#
####################
