####################
#                  #
#                  #
#                  #
##   ###########   #
#     #            #
#     #            #
#   ################
#                  #
#                  #
################   #
#              #   #
#              #   #
#                  #   
####################