####################
##       -        ##
#      ######      #
###              ###
#    #        #    #
#    ##      ##    #
#    ###    ###    #
#### #        # ####
#    #  ####  #    #
# ################ #
#                  #
#########          #
#       #########  #
#%                 #
####################
