####################
#                  #
#                  #
#  #           #   #
#  #############   #
#          #       #
#          #       #
#########  #########
#       #          #
#       #          #
#       #########  #
#  ######       #  #
#                  #
#                  #   
####################