####################
#                  #
#     =######      #
# #=  =        #=  #
# #=############=  #
#  =       #    =  #
#  =       #%   =  #
#########= #########
#       #=         #
#    =###=##### #= #
#    =  ###   ###= #
# =# =  #   -   ##=#
# =######  ###= # =#
# =           =   =#   
####################
