####################
#                  #
#      ######      #
#  #           #   #
#  #############   #
#          #       #
#          #%      #
#########  #########
#       #          #
#     ### ##### #  #
#       ###   ###  #
#  #    #       ## #
#  ######  ###  #  #
#                  #   
####################