####################
#                  #
#     =######      #
# =#  =        #=  #
# =#############=  #
# =        #    =  #
# =        #%   =  #
#########= #########
#       #=         #
#    =###=##### #= #
#    =  ###   ###= #
# =# =  #   -   ##=#
# =######  ###= # =#
# =           =   =#   
####################
